Редакцијски пречишћен текст
 
 
На основу члана 177. став 1. Закона о јавном бележништву („Службени гласник РС”, број 31/11),
Министар правде доноси
 
ПРАВИЛНИК
о привременом броју јавнобележничких места и службеним седиштима јавних бележника и јавнобележничким местима за која ће се расписати конкурс за првих 100 јавних бележника

"Службени гласник РС", бр. 31 од 12. априла 
	2012, 57 од 30. маја 2014.
 
Члан 1.
Одређује се привремени број јавнобележничких места и службена седишта јавних бележника за подручје: 
	
1) oпштине Ада – једно јавнобележничко место, са седиштем у Ади;
2) општине Александровац – два јавнобележничка места, са седиштем у Александровцу;
3) општине Алексинац – три јавнобележничка места, са седиштем у Алексинцу;
4) општине Алибунар – једно јавнобележничко место, са седиштем у Алибунару;
5) општине Апатин – два јавнобележничка места, са седиштем у Апатину;
6) општине Аранђеловац – два јавнобележничка места, са седиштем у Аранђеловцу;
7) општине Ариље – једно јавнобележничко место, са седиштем у Ариљу;
8) општине Бабушница – једно јавнобележничко место, са седиштем у Бабушници;
9) општине Бајина Башта – једно јавнобележничко место, са седиштем у Бајиној Башти;
10) градске општине Барајево – једно јавнобележничко место, са седиштем у Барајеву;
11) општине Баточина – једно јавнобележничко место, са седиштем у Баточини;
12) општине Бач – једно јавнобележничко место, са седиштем у Бачу;
13) општине Бачка Паланка – два јавнобележничка места, са седиштем у Бачкој Паланци;
14) општине Бачка Топола – два јавнобележничка места, са седиштем у Бачкој Тополи;
15) општине Бачки Петровац – једно јавнобележничко место, са седиштем у Бачком
Петровцу;
16) општине Бела Паланка – једно јавнобележничко место, са седиштем у Белој Паланци;
17) општине Бела Црква – једно јавнобележничко место са седиштем у Белој Цркви;
18) општине Беочин – једно јавнобележничко место, са седиштем у Беочину;
19) општине Бечеј – два јавнобележничка места, са седиштем у Бечеју;
20) општинe Блаце – једно јавнобележничко место, са седиштем у Блацу;
21) општине Богатић – једно јавнобележничко место, са седиштем у Богатићу;
22) општине Бојник – једно јавнобележничко место, са седиштем у Бојнику;
23) општине Бољевац – једно јавнобележничко место, са седиштем у Бољевцу;
24) општине Бор – три јавнобележничка места, са седиштем у Бору;
25) општине Босилеград – једно јавнобележничко место, са седиштем у Босилеграду;
26) општине Брус – једно јавнобележничко место, са седиштем у Брусу;
27) општине Бујановац – два јавнобележничка места, са седиштем у Бујановцу;
28) града Ваљева – четири јавнобележничка места, са седиштем у граду Ваљеву;
29) општине Варварин – једно јавнобележничко место, са седиштем у Варварину;
30) општине Велика Плана – два јавнобележничка места, са седиштем у Великој Плани;
31) општине Велико Градиште – једно јавнобележничко место, са седиштем у Великом Градишту;
32) градске општине Вождовац – седам јавнобележничких места, са седиштем у Београду на територији градске општине Вождовац;
33) општине Владимирци – једно јавнобележничко место, са седиштем у Владимирцима;
34) општине Владичин Хан – једно јавнобележничко место, са седиштем у Владичином Хану;
35) општине Власотинце – два јавнобележничка места, са седиштем у Власотинцу;
36) града Врања – четири јавнобележничка места са седиштем у граду Врању;
37) градске општине Врачар – три јавнобележничка места, са седиштем у Београду на територији градске општине Врачар;
38) општине Врбас – два јавнобележничка места, са седиштем у Врбасу;
39) општине Врњачка Бања – два јавнобележничка места, са седиштем у Врњачкој Бањи;
40) општине Вршац – три јавнобележничка места са седиштем у Вршцу;
41) општине Гаџин Хан – једно јавнобележничко место, са седиштем у Гаџином Хану;
42) општине Голубац – једно јавнобележничко место, са седиштем у Голупцу;
43) општине Горњи Милановац – два јавнобележничка места, са седиштем у Горњем Милановцу;
44) градске општине Гроцка – четири јавнобележничка места, са седиштем у Гроцкој;
45) општине Деспотовац – једно јавнобележничко место, са седиштем у Деспотовцу;
46) општине Димитровград – једно јавнобележничко место, са седиштем у Димитровграду;
47) општине Дољевац – једно јавнобележничко место, са седиштем у Дољевцу;
48) општине Жабаљ – два јавнобележничка места, са седиштем у Жабљу;
49) општине Жабари – једно јавнобележничко место, са седиштем у Жабарима;
50) општине Жагубица – једно јавнобележничко место, са седиштем у Жагубици;
51) општине Житиште – једно јавнобележничко место, са седиштем у Житишту;
52) општине Житорађа – једно јавнобележничко место, са седиштем у Житорађи;
53) града Зајечара – три јавнобележничка места, са седиштем у граду Зајечару;
54) градске општине Звездара – шест јавнобележничких места, са седиштем у Београду на територији градске општине Звездара;
55) градске општине Земун – седам јавнобележничких места, са седиштем у Београду на територији градске општине Земун;
56) града Зрењанина – шест јавнобележничких места, са седиштем у граду Зрењанину;
57) општине Ивањица – два јавнобележничка места, са седиштем у Ивањици;
58) општине Инђија – два јавнобележничка места, са седиштем у Инђији;
59) општине Ириг – једно јавнобележничко место, са седиштем у Иригу;
60) града Јагодине – три јавнобележничка места, са седиштем у граду Јагодини;
61) општине Кањижа – два јавнобележничка места, са седиштем у Кањижи;
62) општине Кикинда – три јавнобележничка места, са седиштем у Кикинди;
63) општине Кладово – једно јавнобележничко место, са седиштем у Кладову;
64) општине Кнић – једно јавнобележничко место, са седиштем у Книћу;
65) општине Књажевац – два јавнобележничка места, са седиштем у Књажевцу;
66) општине Ковачица – два јавнобележничка места, са седиштем у Ковачици;
67) општине Ковин – два јавнобележничка места, са седиштем у Ковину;
68) општине Косјерић – једно јавнобележничко место, са седиштем у Косјерићу;
69) општине Коцељева – једно јавнобележничко место, са седиштем у Коцељеви;
70) града Крагујевца – седам јавнобележничких места, са седиштем у граду Крагујевцу;
71) града Краљева – пет јавнобележничких места, са седиштем у граду Краљеву;
72) општине Крупањ – једно јавнобележничко место, са седиштем у Крупњу;
73) града Крушевца – шест јавнобележничких места, са седиштем у граду Крушевцу;
74) општине Кула – два јавнобележничка места, са седиштем у Кули;
75) општине Куршумлија – једно јавнобележничко место, са седиштем у Куршумлији;
76) општине Кучево – једно јавнобележничко место, са седиштем у Кучеву;
77) градске општине Лазаревац – три јавнобележничка места, са седиштем у Лазаревцу;
78) општине Лајковац – једно јавнобележничко место, са седиштем у Лајковцу;
79) општине Лапово – једно јавнобележничко место, са седиштем у Лапову;
80) општине Лебане – једно јавнобележничко место, са седиштем у Лебану;
81) града Лесковца – седам јавнобележничких места, са седиштем у граду Лесковцу;
82) града Лознице – четири јавнобележничка места, са седиштем у граду Лозници;
83) општине Лучани – једно јавнобележничко место, са седиштем у Лучанима;
84) општине Љиг – једно јавнобележничко место, са седиштем у Љигу;
85) општине Љубовија – једно јавнобележничко место, са седиштем у Љубовији;
86) општине Мајданпек – једно јавнобележничко место, са седиштем у Мајданпеку;
87) општине Мали Зворник – једно јавнобележничко место, са седиштем у Малом Зворнику;
88) општине Мали Иђош – једно јавнобележничко место, са седиштем у Малом Иђошу;
89) општине Мало Црниће – једно јавнобележничко место, са седиштем у Малом Црнићу;
90) општине Медвеђа – једно јавнобележничко место, са седиштем у Медвеђи;
91) градске општине Медијана – четири јавнобележничка места, са седиштем у Нишу, на територији градске општине Медијана;
92) општине Мерошина – једно јавнобележничко место, са седиштем у Мерошини;
93) општине Мионица – једно јавнобележничко место, са седиштем у Мионици;
94) градске општине Младеновац – три јавнобележничка места, са седиштем у Младеновцу;
95) општине Неготин – два јавнобележничка места, са седиштем у Неготину;
96) градске општине Нишка Бања – једно јавнобележничко место, са седиштем у Нишкој Бањи;
97) општине Нова Варош – једно јавнобележничко место, са седиштем у Новој Варош;
98) општине Нова Црња – једно јавнобележничко место, са седиштем у Новој Црњи;
99) градске општине Нови Београд – девет јавнобележничких места, у Београду на територији градске општине Нови Београд;
100) општине Нови Бечеј – два јавнобележничка места, са седиштем у Новом Бечеју;
101) општине Нови Кнежевац – једно јавнобележничко место, са седиштем у Новом Кнежевцу;
102) града Новог Пазара – четири јавнобележничка места, са седиштем у граду Новом Пазару;
103) града Новог Сада – 13 јавнобележничких места, са седиштем у граду Новом Саду;
104) градске општине Обреновац – три јавнобележничка места, са седиштем у Обреновцу;
105) општине Опово – једно јавнобележничко место, са седиштем у Опову;
106) општине Осечина – једно јавнобележничко место, са седиштем у Осечини;
107) општине Оџаци – два јавнобележничка места, са седиштем у Оџацима;
108) градске општине Палилула – седам јавнобележничких места, са седиштем у Београду на територији градске општине Палилула;
109) градске општине Палилула – три јавнобележничка места са седиштем у Нишу на територији градске општине Палилула;
110) градске општине Пантелеј – два јавнобележничка места са седиштем у Нишу на територији градске општине Пантелеј;
111) града Панчева – шест јавнобележничких места, са седиштем у граду Панчеву;
112) општине Параћин – три јавнобележничка места, са седиштем у Параћину;
113) општине Петровац на Млави – два јавнобележничка места, са седиштем у Петровцу на Млави;
114) општине Пећинци – једно јавнобележничко место, са седиштем у Пећинцима;
115) општине Пирот – три јавнобележничких места, са седиштем у Пироту;
116) општине Пландиште – једно јавнобележничко место, са седиштем у Пландишту;
117) града Пожаревца – четири јавнобележничка места, са седиштем у граду Пожаревцу;
118) општине Пожега – два јавнобележничка места, са седиштем у Пожеги;
119) општине Прешево – два јавнобележничка места, са седиштем у Прешеву;
120) општине Прибој – два јавнобележничка места, са седиштем у Прибоју;
121) општине Пријепоље – два јавнобележничка места, са седиштем у Пријепољу;
122) општине Прокупље – два јавнобележничка места, са седиштем у Прокупљу;
123) општине Ражањ – једно јавнобележничко место, са седиштем у Ражњу;
124) градске општине Раковица – пет јавнобележничких места, са седиштем у Београду на територији градске општине Раковица;
125) општине Рача – једно јавнобележничко место, са седиштем у Рачи;
126) општине Рашка – два јавнобележничка места, са седиштем у Рашкој;
127) општине Рековац – једно јавнобележничко место, са седиштем у Рековцу;
128) општине Рума – три јавнобележничка места, са седиштем у Руми;
129) градске општине Савски венац – два јавнобележничка места, са седиштем у Београду на територији градске општине Савски венац;
130) општине Свилајнац – једно јавнобележничко место, са седиштем у Свилајнцу;
131) општине Сврљиг – једно јавнобележничко место, са седиштем у Сврљигу;
132) општине Сента – једно јавнобележничко место, са седиштем у Сенти;
133) општине Сечањ – једно јавнобележничко место, са седиштем у Сечњу;
134) општине Сјеница – два јавнобележничка места, са седиштем у Сјеници;
135) града Смедерева – пет јавнобележничких места, са седиштем у граду Смедереву; 
	
136) општине Смедеревска Паланка – три јавнобележничка места, са седиштем у Смедеревској Паланци;
137) општине Сокобања – једно јавнобележничко место са седиштем у Сокобањи;
138) града Сомбора – четири јавнобележничка места, са седиштем у граду Сомбору;
139) градске општине Сопот – једно јавнобележничко место, са седиштем у Сопоту;
140) општине Србобран – једно јавнобележничко место, са седиштем у Србобрану;
141) града Сремска Митровица – четири јавнобележничка места, са седиштем у граду Сремска Митровица;
142) општине Сремски Карловци – једно јавнобележничко место са седиштем у Сремским Карловцима;
143) општине Стара Пазова – три јавнобележничка места, са седиштем у Старој Пазови;
144) градске општине Стари град – три јавнобележничка места, са седиштем у Београду на територији градске општине Стари град;
145) града Суботица – шест јавнобележничких места, са седиштем у граду Суботица;
146) општине Сурдулица – једно јавнобележничко место са седиштем у Сурдулици;
147) градске општине Сурчин – два јавнобележничка места, са седиштем у Сурчину;
148) општине Темерин – два јавнобележничка места, са седиштем у Темерину;
149) општине Тител – једно јавнобележничко место, са седиштем у Тителу;
150) општине Топола – једно јавнобележничко место, са седиштем у Тополи;
151) општине Трговиште – једно јавнобележничко место, са седиштем у Трговишту;
152) општине Трстеник – два јавнобележничка места, са седиштем у Трстенику;
153) општине Тутин – два јавнобележничка места, са седиштем у Тутину;
154) општине Ћићевац – једно јавнобележничко место, са седиштем у Ћићевцу;
155) општине Ћуприја – два јавнобележничка места, са седиштем у Ћуприји;
156) општине Уб – два јавнобележничка места, са седиштем у Убу;
157) града Ужице – четири јавнобележничка места са седиштем у граду Ужице;
158) градске општине Црвени Крст – два јавнобележничка места са седиштем у Нишу на територији градске општине Црвени Крст;
159) општине Црна Трава – једно јавнобележничко место, са седиштем у Црној Трави;
160) општине Чајетина – једно јавнобележничко место, са седиштем у Чајетини;
161) града Чачка – пет јавнобележничких места, са седиштем у граду Чачак;
162) општине Чока – једно јавнобележничко место, са седиштем у Чоки;
163) градске општине – Чукарица, седам јавнобележничка места, са седиштем у Београду на територији градске општине Чукарица;
164) града Шабац – пет јавнобележничких места, са седиштем у граду Шабац;
165) општине Шид – два јавнобележничка места, са седиштем у Шиду.

	Члан 2.*

	Одређују се јавнобележничка места за која ће се расписати конкурс за првих 
	100 јавних бележника:*

	1) за подручје Основног суда у Аранђеловцу – једно јавнобележничко место, и 
	то: општина Аранђеловац једно место;*

	2) за подручје Основног суда у Бачкој Паланци – једно јавнобележничко место, 
	и то: општина Бачка Паланка једно место;*

	3) за подручје Првог основног суда у Београду – 12 јавнобележничких места, и 
	то, по градским општинама: Врачар два места, Звездара четири места, Палилула 
	четири места, Савски венац једно место и Стари град једно место;*

	4) за подручје Другог основног суда у Београду – 14 јавнобележничких места, 
	и то, за градске општине: Вождовац четири места, Гроцка два места, Раковица 
	три места, Чукарица пет места;*

	5) за подручје Трећег основног суда у Београду – 14 јавнобележничких места, 
	и то, за градске општине: Земун пет места, Нови Београд седам места и Сурчин 
	два места;*

	6) за подручје Основног суда у Бечеју – jедно јавнобележничко место, и то: 
	општина Бечеј једно место;*

	7) за подручје Основног суда у Ваљеву – два јавнобележничка места, и то: 
	град Ваљево два места;*

	8) за подручје Основног суда у Врбасу – једно јавнобележничко место, и то: 
	општина Кула једно место;*

	9) за подручје Основног суда у Горњем Милановцу – једно јавнобележничко 
	место, и то: општина Горњи Милановац једно место;*

	10) за подручје Основног суда у Ивањици – једно јавнобележничко место, и то: 
	општина Ивањица једно место;*

	11) за подручје Основног суда у Зајечару – једно јавнобележничко место, и то: 
	град Зајечар једно место;*

	12) за подручје Основног суда у Зрењанину – два јавнобележничка места, и то: 
	град Зрењанин два места;*

	13) за подручје Основног суда у Јагодини – два јавнобележничка места, и то: 
	град Јагодина два места;*

	14) за подручје Основног суда у Кикинди – једно јавнобележничко место, и то: 
	општина Чока једно место;*

	15) за подручје Основног суда у Крагујевцу – три јавнобележничка места, и то: 
	град Крагујевац три места;*

	16) за подручје Основног суда у Краљеву – једно јавнобележничко место, и то: 
	град Краљево једно место;*

	17) за подручје Основног суда у Лазаревцу – једно јавнобележничко место, и 
	то: градска општина Лазаревац једно место;*

	18) за подручје Основног суда у Лесковцу – једно јавнобележничко место, и то: 
	град Лесковац једно место;*

	19) за подручје Основног суда у Лозници – једно јавнобележничко место, и то: 
	град Лозница једно местo;*

	20) за подручје Основног суда у Младеновцу – једно јавнобележничко место, и 
	то: градска општина Младеновац једно место;*

	21) за подручје Основног суда у Нишу – четири јавнобележничка места, и то: 
	град Ниш четири места;*

	22) за подручје Основног суда у Новом Пазару – једно јавнобележничко место, 
	и то: град Нови Пазар једно место;*

	23) за подручје Основног суда у Новом Саду – девет јавнобележничких места, и 
	то: град Нови Сад девет места;*

	24) за подручје Основног суда у Обреновцу – два јавнобележничка места, и то: 
	градска општина Обреновац два места;*

	25) за подручје Основног суда у Панчеву – четири јавнобележничка места, и то: 
	град Панчево четири места;*

	26) за подручје Основног суда у Пироту – једно јавнобележничко место, и то: 
	општина Пирот једно место;*

	27) за подручје Основног суда у Пожаревцу – једно јавнобележничко место, и 
	то: град Пожаревац једно место;*

	28) за подручје Основног суда у Пожеги – једно јавнобележничко место, и то: 
	општина Пожега једно место;*

	29) за подручје Основног суда у Пријепољу – једно јавнобележничко место, и 
	то: општина Пријепоље једно место;*

	30) за подручје Основног суда у Сенти – два јавнобележничка места, и то: 
	општина Сента једно место и општина Кањижа једно место;*

	31) за подручје Основног суда у Сомбору – три јавнобележничка места, и то: 
	град Сомбор два места и општина Оџаци једно место;*

	32) за подручје Основног суда у Сремској Митровици – једно јавнобележничко 
	место, и то: град Сремска Митровица једно место;*

	33) за подручје Основног суда у Старој Пазови – једно јавнобележничко место, 
	и то: општина Стара Пазова jeдно место;*

	34) за подручје Основног суда у Суботици – два јавнобележничка места, и то: 
	град Суботица два места;*

	35) за подручје Основног суда у Убу – једно јавнобележничко место, и то: 
	општина Уб једно место;*

	36) за подручје Основног суда у Чачку – два јавнобележничка места, и то: 
	град Чачак два места;*

	37) за подручје Основног суда у Шапцу – два јавнобележничка места, и то: 
	град Шабац два места.*
*Службени гласник РС, број 57/2014
Члан 3.
Овај правилник ступа на снагу осмог дана од дана објављивања у „Службеном гласнику Републике Србије”.
 
Број 110-00-22/2012-05 
	
У Београду, 2. априла 2012. године
Министар,

Снежана Маловић, с.р.